-12
12
-8
8
0000000000000000000000000
1111111111111111111111110
0000000000000000000000000
0000000000000000010000100
0000000000000000000000000
0000000000000000000000000
0000000000000111111100000
0000000000000111111100000
0100000000000111111100000
0000000000000111111100000
0001000000000111111100000
0000000000000111111100000
0000000000000111111100000
0000000000000000000000000
0000000000000000000000000
0000000000100000000000000
0001000000000000100000000
