-11
11
-4
6
00000000000000000000000
00000000000000001000010
00000000000000000000000
00000000000000000000000
00000000000011111110000
00000000000011111110000
10000000000011111110000
00000000000011111110000
00100000000011111110000
00000000000011111110000
00000000000011111110000
